vily Rotonda u Vincenzy: Andrea Palladio

umìlci na dvoøe Rudolfa II nepatøí: Mistr Pavol z Levoèe

barevná perspektiva Nizozemí: hnìdá, zelená, modrá

Portrét manželù Arnolfini: Gentský oltáø

Albrecht Durrer: tvùrce grafických listù

mimesis: nápodoba vidìného výtvarného umìní

malby s výjevy sv. Františka František z Assisi: Giotto di Bondone

Michelangelo papež: Julia II

sacra conversazione: zachycení Madony s dítìtem

profánní ikonografie: Zeuxis a Parhasios

dispozice a fasáda kostela II Gesù v øímì: pøedobraz barokního kostela

quattrocento: italské umìní 15. stol.

Mona Lisa: La Gioconda

olajomalba na plátnì: Nizozemí

rinascitá poprvé použil Lorenzo Ghiberti

Giorgio Vasari: dìtství, jinošství, zralý vìk

Lorenzo Ghiberti soutìž: Reliéf pro východní dveøe florentského babtisteria

žánr: zachycování výjevù z bìžného života

kupole florentské katedrály Santa Maria: Filippo Brunelleschi

figura serpentinata: esovité prohnutí

Giorgio Vasari: autor spisu život nejvýznamnìjších malíøù

založení malíøské akademie Accademia: Annibale a Ludovico Carracci

Robert Campina: použití barevné polychromie

princip propojení všech umìleckých druhù: bel composto

nejvìtší gotický oltáø: v kostele panny marie Krakov

prostor v pøízemí nebo suterénu: sala terrena

dvor Rudolfa II: Giuseppe Arcimboldo

spoluautor Petra Paula Rubense: Anthonis van Dyck

autor fresek camera degli Sposi: Andrea Mantegna

kunstkammera: encyklopedická sbírka

ve službách Františka Antonína: Ferdinand Maxmilián

iluminovaný rukopis 15. stol.: pøebohaté hodinky

trompe loeil: iluzivní malba

naturismus: annibale Carracci

tempietto san pietro: donato Bramante